####/\####
#........#
#........#
#........#
#........#
#........#
#........#
#........#
#@.......#
##########